111111111111111111111111111
100000100000001010000000001
101110100010101010111110101
100010101000101000001010101
101010101011101011101011101
100010000010000000001002001
111111111111111111111111111